111111111111111111
10C0C010000C000001
1000001000000C0001
100000000011100001
100P00000000000CE1
10000C01110C000001
100000010100000001
111111111111111111
