111111111111111111
10C0C010000C000001
1000001000000C0001
100000000011100001
100P00000000000CE1
10000C0011111C0001
1000000C10C0110011
100000001000111111
100000001100111111
100000000000011111
111111111111111111
