11111
10C01
1P001
100E1
11111

