111111111111111111
100000000000000001
100000000001100001
100000000000100001
100P00000001100001
1000000000100000C1
100000000010000001
111111111111111111
