111111111111111111
100000000000000001
1000E0000001100001
10000P0P0000100001
100P00000001100001
1000000000100000C1
100000000010000001
111111111111111111
