111111111111111111
100000000000000001
100E00000001100001
100000000000100001
100P00000001100001
100000000010000001
100000000010000001
111111111111111111
