111111111111111111
100000000010000001
10CE000C0011100001
100000000010100001
100P00000011100001
100000000010000C01
100000000010000001
111111111111111111
