111111111111111111
100000000000000001
10000E000001100001
100000000000100001
100P00000001100001111
1000000000100000000C1
100000000010000000001
111111111111111111111
